#### ####
#  ###  #
# $ * $ #
#   +   #
### .$###
  # . #
  #####