 #####
 #   #
 # # ##
## *  ##
# $*$  #
#  * # #
## .  +#
 #######