  ##### 
###   # 
# $ # ##
# #  . #
# .  # #
##$#.$ #
 #@  ###
  ####